--------
---xxxx-
-xx-----
-------t
t----x-t
t------t
t----ttt
tt------
--t-----
--t-----

--------
---tttt-
-tt-----
--------
-----x--
--------
--------
--------
--------
--------

--------
--------
--------
--------
-----x--
--------
--------
--------
--------
--------

--------
--------
--------
--------
-----t--
--------
--------
--------
--------
--------
